######### ######
 ....#....#..0. 
####.#.##.#.####
#......  ......#
#.###.#__#.###.#
#o....#EE#.....#
#.###.####.###.#
#..............#
####.#.##.#.####
 .0..#....#.... 
######### ######
