################
 ....#....#..0. 
####.#.##.#.####
#..............#
#.###.####.###.#
#o....#EE|.....#
#.###.####.###.#
#..............#
####.#.##.#.####
 .0..#....#.... 
################
