################
#....#....#....#
####.#.##.#.####
 .............. 
#.###.####.###.#
#o....#EE|.....#
#.###.####.###.#
 .............. 
####.#.##.#.####
#....#....#....#
################
