# #### ## ######
#....#.##.#....#
##.#.#.##.#.#.##
#..#......o.#..#
#.###.####.###.#
#.....#EE|.....#
#.###.####.###.#
#..#........#..#
##.#.#.##.#.#.##
#....#.##.#....#
# #### ## ######
