# #### ## ######
#.0..#.##.#....#
##.#.#.##.#.#.##
#..#......o.#..#
#.###.#__#.###.#
#.....#EE#.....#
#.###.####.###.#
#..#........#..#
##.#.#.##.#.#.##
#....#.##.#..0.#
# #### ## ######
