# ############ #
#..0...##......#
#.#.##.##.##.#.#
#...#..  ..#...#
#.###.#__#.###.#
 .....#EE#..... 
#.###.####.###.#
#...#.o....#...#
#.#.##.##.##.#.#
#......##...0..#
# ############ #
