# ############ #
#......##......#
#.#.##.##.##.#.#
#...#......#...#
#.###.####.###.#
#.....#EE|..#..#
#.###.####.###.#
#...#.o....#...#
#.#.##.##.##.#.#
#......##......#
# ############ #
