# ############ #
#..0...##......#
#.#.##.##.##.#.#
#...#......#...#
#.###.####.###.#
#.....#EE|..#..#
#.###.####.###.#
#...#.o....#...#
#.#.##.##.##.#.#
#......##...0..#
# ############ #
