# ########### ###############
#o............#.............#
#.##.####.###.#.###.####.##.#
#.#.....#.....#.....#.....#.#
#.#.###.#.###.#.###.#.###.#.#
#...#.........#.........#...#
###.#.#####.#...#.#####.#.###
  #.#.#.....#.#.#.....#.#.#  
###.#.#.###.#.#.#.###.#.#.###
  #.........#.#.#.........   
#####.#.#####.#.#####.#.#####
#.....#.......#.......#.....#
#.###.#####.#####.#####.###.#
#.#...#.......E.......#.#...#
#.#.#.#.###.##_##.###.#.#.#.#
#.#.#.......#EEE#.......#.#.#
#.#.#.#.###.#####.###.#.#.#.#
#.#...#...............#.#...#
#.###.#####.#####.#####.###.#
#.....#.......#.......#.....#
#####.#.#####.#.#####.#.#####
   .........#.#.#.........#  
###.###.###.#.#.#.###.#.#.###
  #.........#.#.#.....#.#.   
# #########.#...#.#####.#.###
#.......#.....#.....#...#...#
#######.#.###.#.###.#.#####.#
  #.....#.....#.....#....##.#
###.#####.###.#.###.####.##.#
#.............#.............#
# ########### ###############
