# ########################### #
#...#.........#.........#.....#
#.#.#.#######.#.###.####.####.#
#.#.#...#...........#....#  #.#
#.#.###.#.###.#.###.#.#######.#
#.#.....#.....#.....#...#.....#
#.###.#####...#...#####.#.#.###
#.....#.....#####.....#.#.#..# 
#.#######.....#...###.#.#.##.##
#.....#.....#.#.#.............#
#####.#.#####.#.#####.#.#######
     .#.......#..o....#.       
#####.#####.#####.#####.#####.#
#.....#.......E.......#.....#.#
#.#.#.#.###.##_##.###.#.#.#.#.#
#.#.#.......#EEE#.......#.#.#.#
#.#.#.#.###.#####.###.#.#.#.#.#
#.#...#...............#.#.....#
#.###.#####.#####.#####.###.###
 .#...#.......#.......#....... 
###.#.#.###.#.#.#.###.#.#.###.#
#...#.#.....#.#.#.....#.#.###.#
#.###.#####.#...#.#####.#.###.#
#...#...#.....#.....#...#...#.#
#.#.###.#.###.#.###.#.#####.#.#
#.#.#...#.....#.....#....##.#.#
#.#.#.###.###.#.###.####.##...#
#.............#.............# #
# ########################### #
