####### ####### ################# ############## ###
#.......#...........#..............#........#......#
#.#####.#.#####.###.#.####.###.###.#.###.##.#.####.#
#.#.....#.#.......#.#.#....#...###.#...#.##.#.#  #.#
#.#.###.#.#.#####.#.....##...###.....#.#.##...#  #.#
 .......#.......#...###..#.#.....###.#....###.####. 
###.#.###.#.###.#.#....#.#.#####.....####.#........#
#...#.....#.......#.##.#.......#.###.#....#.#.####.#
#.###.#.###.#.#####.##.#######.#.# #.#.##.#.#......#
#...#.#...#.#.....#.##.........#.###.#..#...#####.##
#.#.#.###.#.#.###.#....##__##.#.......#.#.#.#......#
 .#.....#...#..#...###.#EEEE#.#.#####.#...#...####. 
#.#####.#.####...#...#.######.#.......#.#####.####.#
#.......#......#.#.#.#........##.###.##.....#......#
############.###.#.#...######....###...#.##.########
 ..............#.#.###.#....#.##....#.##.#.........#
#.#.#.#####.##.#.........##.#.##.##.#.#..#.#######.#
#.#.#.#........#####.#.#.##.#....##.#...##.......#.#
#...#...#.##.####....#.#..o..##.###.##.####.####.#.#
###.###.#.#.....#.####.###.#.##.#...........####.#.#
  #.....#...###.#..........#......#########........#
  ##### ##### # ################# #       ###### ###
