####### ####### ################# ############## ###
#.......#...........#........#.....#........#......#
#.#.#.#########.#.######.#.###.###.#####.##.#.####.#
#.#.#...#.#.......#.#.#....#...###.#...#..#.#.#  #.#
#.#.###.#.#######.#.....##...#.#.....#.##.#...#  #.#
 .......#.......#...###..#.#...#.#.#.#....###.####. 
###.#.###.#.###.#.#....#.#.#####.....####.#........#
#...#.....#.......#.##.#.......#.###.#....#.#.####.#
#.###.#.###.#.#####.##.#####.#.#.# #.#.##.#.#......#
#.#.#.#...#.#.....#.##.........#.###.#..#...#####.##
#.#.#.###.#.#.###.#....##__##.#.......#.#.#.#......#
 .....#.#...#..#...###.#EEEE#.#.#####.#...#...####. 
#.#####.#.####...#...#.######.#.......#.#####.####.#
#.......#......#.#.#.#........##.###.##.....#......#
############.###.#.#...######....###...#.##.########
 ..............#.#.###.#....#.##....#.##.#.........#
#.#.#.#####.##.#.........##.#.##.##.#.#..#.#######.#
#.#.#.#........#####.#.#.##.#....##.#...##.......#.#
#...#...#.##.####....#.#.....##.###.##.####.####.#.#
###.###.#.#.....#.####.###.#.##.#...........####.#.#
  #.....#...###.#..........#......#########........#
  ##### ##### # ################# #       ###### ###
