# ################# #
#.....#...0...#.....#
#.###...#####...###.#
#..#..#.......#..#..#
##.#.##.#####.##.#.##
##.#......#......#.##
#....####.#.####....#
#.###...#.#.#...###.#
 .....#.......#..... 
#.#####.##_##.#######
#.......#EEE#.#.....#
#.#####.#_#_#.#.###.#
#.###...........###.#
#.....#.#.#.#.#.....#
#.#####.#...#.#####.#
#.#.....##.##.....#.#
#.#.#.#...o...#.#.#.#
#.#.#.####.####.#.#.#
#.#.#...........#.#.#
#..0..#########..0..#
# #####       ##### #
