# ################# #
#.....#.......#.....#
#.###...#####...###.#
#..#..#.......#..#..#
##.#.##.#####.##.#.##
##.#......#......#.##
#....####.#.####....#
#.###...#.#.#...###.#
 .....#.......#..... 
#.#####.##_##.#######
#.......#EEE#.#.....#
#.#####.......#####.#
#.###.#.#####.#.###.#
#.....#...#...#.....#
#.#####.#...#.#####.#
#.#.....##.##.....#.#
#.#.#.#.......#.#.#.#
#.#.#.####.####.#.#.#
#.#.#...........#.#.#
#.....#########.....#
# #####       ##### #
