#### ######## ##### #
 .........#.###..... 
####.####.#.....###.#
   #......#.###...#.#
####.####...#####.#.#
#.........#.......#.#
#.#.#####.#.#####.#.#
#.#.###...#...#.....#
#.#.....#####...###.#
#.#####.......#.###.#
 .......#EEE#.#..... 
#.#####.......#.###.#
#.#.....#####...###.#
#.#.###...#...#.....#
#.#.#####.#.#####.#.#
#.........#.......#.#
####.####...#####.#.#
   #......#.###...#.#
####.####.#.....###.#
 .........#.###..... 
#### ######## ##### #
