#### ######   ##### #
 .........#####..... 
####.####.#.....###.#
   #o.....#.###...#.#
####.####...#####.#.#
#.......#.#.......#.#
#.#.###.#.#.#####.#.#
#.#.###.#.#.#.......#
#.#0..........#.###.#
#.#####.##_##.#.###.#
 .......#EEE#.#..... 
#.#####.#_#_#.#.###.#
#.#...........#.###.#
#.#.###.#.#.#...0...#
#.#.###.#.#.#####.#.#
#.......#.#.......#.#
####.####...#####.#.#
   #......#.###...#.#
####.####.#.....###.#
 ......0..#####..... 
#### ######   ##### #
