# ##### #################### ##
#.......##.....#.....##.......#
#.#####....#.#####.#....#####.#
#.#.....####...#...####.....#.#
#.#.#.#....#.#...#.#....#.#.#.#
#.#.#.####...#.#.#...####.#.#.#
#...#......#.......#......#...#
######.#####.#####.#####.######
     #.......#####.......      
## ###.#####...E...#####.######
#..#.........##_##.#......#    
  .#.####.##.#EEE#.#..#.#.#    
##.#....#..#.#####.#.##.#.#####
 #...##.##.#.......#....#.....#
######..#..###.####.#########.#
 .....#...#...o...#.#...#..... 
#####...#...#.###.#...#...#####
    #####.###.....#.#.###.#    
#####.........###.#.#.#...#####
#.....#.##.#...#....#.#.#.....#
#.#####.##.###.#.##.#.#.##.##.#
#.#.....##.#...#.##...#.#...#.#
#.#.#.#....#.#......#.....#.#.#
#.#.#.####.#.#.###.###.#.##.#.#
#...#........#...#.###.#.##...#
##.###.##.##...#.#.....#....###
##.###.##.####.#.#.#####.##..##
#..............#.........###..#
# ##### #################### ##
