# ##### #######################
#............#......#.........#
#.#####.##.#.#.####.#.#.#####.#
#.#.....##.#...#..#...#.....#.#
#.#.#.#....#.#...####..#....#.#
#.#.#.####.#.#.###...#.#.####.#
#...#........#.....#..#...#...#
######.#####.#####.#..##.######
     #...#......#........#     
########.#.####...####.########
 ...........##_##............. 
########.##.#EEE#.#..#...######
       #..#.#####.#.##.#       
       #..#.......#....#       
########.#.###.####.##.########
 .....#...#...o...#.##..#..... 
#####...#...#####.....#...#####
    ##### ####.##.#.#######    
             #..#.#.#             
             #....#.#       
#.#####.##.#.#.####.#.#.#####.#
#.#.....##.#...#..#...#.....#.#
#.#.#.#....#.#...####..#....#.#
#.#.#.####.#.#.###...#.#.####.#
#...#........#.....#..#...#...#
######.#####.#####.#..##.######
#############.#.###.###########
#...............#.............#
# ##### #######################
