# ##### ###############################
#............#...........#............#
#.#####.##.#.#.#########.#.#.##.#####.#
#.#.....##.#...#.......#...#.##.....#.#
#.#.#.#....#.#...#####...#.#....#.#.#.#
#.#.#.####.#.#.###...###.#.#.####.#.#.#
#...#........#.....#.....#........#...#
######.#####.#####.#.#####.#####.######
     #...#.......#.#.#.......#...#     
########.#.#####.......#####.#.########
 ..........#.....##_##.....#.......... 
########.#...#.#.#EEE#.#.#...#.########
       #.#####.#.#####.#.#####.#       
       #.......#.......#.......#       
########.#.###.####.####.###.#.########
 .....#..#..##.#.......#.##..#..#..... 
#####...###......#####......###...#####
    ##### ####.#.#...#.#.#### #####    
             #.#.#.#.#.#.#             
             #.#...#...#.#             
##############.###.#.###.##############
#..................#..................#
# ##### ###############################
