#######################################
 ............#
#.#####.######
#.#.....##.#
#.#.#.#......#
#.#.#.######.#
#...#........#
#####.####.###
    #....#....
########.#
#........        ##_##
########.        #EEE#
       #.        #####
       #
########
#
#
##############
             #
             #
##############
#
#
#