########### ####### #
#0....#.....#......0# 
#.###.#.###.#.#.###.#
 .# #.....#...#...#.
#.###.#.#...#####.#.#
#.....#.###.......#.#
#.#####.....#####.#.#
#.#.....###.#.......#
#.#.###.......#.###.#
#...###.##_##.#.###.#
 .#.....#EEE#.#..... 
#.###.#.#####.###...#
#.###.#.......###.#.#
#.......#.###.....#.#
#.#.#####.....#####.#
#.#......o###.#.....#
#.#.#####...#.#.###.#
 .#...#...#.....# #.  
#.###.#.#.###.#.###.#
#.......#0....#.....#
########### ####### #
