# #### ########################## #### #
#.......#...........#........#....#    #
#.#####.#.#.#######.#.######.#.##.#    #
#.#   #.#.#.......#.#.#....#...##.#### #
#.#####.#.#######.#.....##...#.#.....# #
 .......#.......#...###..#.#...#.#.#.#  
#########.#####.#.#....#.#.#####..o..###
#.........#.......#.##.#.......#.###.#  
#.#####.###.#.#####.##.#####.#.#.# #.#  
#...#.......#.......##.......#.#.###.###
 .#.#.#.###.#.#####....#####.#......... 
#.#...#.#...#..#.###.###.....#########.#
#.#####.#.####.#...EE....###...........#
#..............#.##__##.##...#####.#####
################.#EEEE#.#..###...#.#    
#..............#.######.##.....#.#.#####
#.#.#.#####.##.#...........###.........#
#.#.#.#..........#####.###.#...###.###.#
#...#...#.#######....#.###.#.###...###.#
###.###.#.#.......##.......#.....#.....#
  #.# #.#.#.#####.##.#####.#.###.#####.#
  #.###.#.......#.##.#.......#.........#
###.....#####.#.#....#.#.#####.#########
  #.#.#.#...#.#..###...#.......#....... 
# #.....#.#...##.....#.#######.#.#####.#
# ####.##...#....#.#.#.......#.#.#   #.#
#    #.##.#.######.#.#######.#.#.#####.#
#    #....#........#.........#.#.......#
# #### ########################## #### #
