#### ######   ##### #
 .........#####..... 
####.####.#.....###.#
   #o.....#.###...#.#
####.####...#####.#.#
#.......#.#.......#.#
#.#.###.#.#.#####.#.#
#.#.###.#.#.#.......#
#.#...........#.###.#
#.#####.##_##.#.###.#
 .......#EEE#.#..... 
#.#####.##_##.#.###.#
#.#...........#.###.#
#.#.###.#.#.#.......#
#.#.###.#.#.#####.#.#
#.......#.#.......#.#
####.####...#####.#.#
   #......#.###...#.#
####.####.#.....###.#
 .........#####..... 
#### ######   ##### #
