# ##############
#....#...#.#...#
#.##.#.#.#...#.#
 ..........#... 
#####.####.###.#
#...#.#EE|.....#
#.#...####.###.#
 .###.....o.... 
#...#.###.#.##.#
# #.......#....#
  ##############
